~~AAA~~AAAAAAAA~~~~~~~~~~
~AAAA~~AAAAAAAAAAAAA~~~~~
~AAAAA~AAAAAAAAAAAA~~~~~~
AAAAAAAAAAAAAAAAA~~~~~~~~
AAAAAAAA:TTTAAATA:T~~~~~~
AAAAAAA:TTAAA:::::TT~~~~~
AAAA::A:::::A:::T::TT~~~~
~AAAA:A:::AAA:::::::~~~~~
~AAAA:::::::::::::::T~~~~
~AAA:::::::::::::|~::~~~~
~~~A:::T:::T::::~|~~:~~~~
~~~~:::::::TT:::~~~~~~~~~
~/~~T:::::TTTTT~~~~~~~~~~
~~~~~T::~~:TTTT~~~~~~~~~~
~~~~:::~~~~TTT~~~~~~~~~~~
~~~~~~~~~~~~~~~~~~~~~~~~~
~~/~~~~~~~~~~~~~~~~~~~~~~
~~~~~~~~~~~~~~~~~~~~~~~~~
~~~~~~~~~~~~~~~~~~~~~~~~~
