?????????????????????????????
???`???**``?????`````````????
*?```??*```````````?```?`????
**```***```?????`?```?```????
**```***????????```?```?`????
***]**??????`````?```?`````??
*??```??????????```?```?`?`??
*????`?```??????`?```?```?`??
???```?`*``````````?```?`?`??
??``???```??????`````````?`??
??`????`??????????????????`??
??`??```????????????????````?
??````?????```??```?????`**`?
???????```````??`*`?????`**`?
???????????```??```?????````?
?```????????`????`??```???`??
?`*`????????`????`??```???`??
?```????????``````??```````??
?`?????```????`?????????`????
?`?????```????`?????????`????
?`````````???```???????```???
???```???????```???????```???
???```???????```???????```???
????`?????????`?????????`????
????`````````````````````????
????`?????????`??????????????
????`?????????`??????????????
????`???*????````????????????
????``********````???????????
***??`****??*******??????????
??***]*****?****`******??????
????```***??``**********???**
?????`??**?``****`**********?
?????`?***?```*```???``*****?
????```***??`````?????```***?
????```?*?????`?????????`????
?????[??*?????`?????????`????
?`````??*?????`?????????```??
?`??????**???```??`````???`??
?`???????**?``*``?`???`???`??
?`?````?``_````````???`???`??
?`?`??`?`?*?``*``????````?`??
?`?`?``?`?*??```?????`**`?`??
?```?`??`?*???[??????``````??
???`?`??`?**??`??????????????
?????````?**??`??????????????
??????????***?[??????????????
??????????****]**??*?????????
:::::::::*****:*****:::::::::
::::::::****:::::****::::::::
::::*******::::::::***:::::::
