XXXXXXXXXXXXXXXXXXXXXXX
XXXXXXXXXXXXXXXXXXXX..X
XXXX....XXXXXXXRRRRR.XX
XXXX....XXXXXXXRXXXX.XX
XXXX....XXXXXXXRXX...XX
XXXX....XXXXX.RRR.....X
XXXXXDXXXXXXX.RRR..XX.X
XXXXX.XXXXXXX.RRR.XXX.X
XXXXX.XXXXXXX..RR.XXX.X
XXXXX.XX.......R..XXX.X
XXXXX......XX..RXXXXX.X
XXXXXXXX...XXXXRXXXXX.X
XXXXXXXX...XXXRRXXX...X
XXXXXXXX...XXRRRXXX.XXX
XXXXXXXX...XXRXXXXX..XX
XXX...D......RXXXXX..XX
XXX...XXXXXX.RXXX....XX
XXX...XXXXXX.RXXX.XX.XX
XXXDXXXXXXXX.RXXX.XX.XX
XXX.XXXXXXXX.RXXX.XX.XX
XXX.XXX..XXX.-....XX.XX
XXX.XXX.XXXXXRXXXXXX.XX
XXX.XXX.XXXXXRXXXXXX.XX
XXX.XXX.XXXXXRXXXXXX.XX
XXX.XXX......RXXXXXX.XX
XXX..........RXXXXXX.XX
XXXXXXX......RXXXXXX.XX
XXXXXXX......RXXXXXX.XX
XXXXXXXXXXDXXRXXXXXX.XX
XXRRRRRRXX.XXRXXXXXX.XX
XXXRRRRRRX.XXRXXXXXXDXX
XRRRRRRRRX.XXRXXL....XX
XXRXXRRRRR|RRRXX.....XX
XRRX..RRR...RRXX.....XX
XXRX..---...XRRX.....XX
XRRX..RRR..XXRRXL...LXX
XXRXXRRRRXXXXXXXXXXXXXX
XRRRRRRRRXXXXXXXXXXXXXX
XXXRRRRRRXXXXXXXXXXXXXX
XXRRRRRRXXXXXXXXXXXXXXX
XXXXXXXXXXXXXXXXXXXXXXX
