MMMMM==!!
MMMM=====
M!!=====!
!===!==!!
=!=!==!!!
=~|~==!MM
~~~~~=!!M
~~~~~===M
~~~~!!!MM
