MMMMMMM~~~~~~~
MMMMMMM~~~~~~~
MMMMMMMM~~~~~~
MMMMMMMMMM~~~~
MMMMMMM!!M~~~~
MMMMMM!!!!~~~~
MMMMM!!==~~~~~
MMMMM====~~~~~
MMMMM===~~~~~~
MMMMM===~~~~~~
MMMM====~~~~~~
MMMMM===~~~~~~
MMMMM==!~~~~~~
MMMMM!!=~~~~~~
MMMM!!=!!~~~~~
MMMMM!!!~~~~~~
MMMMMM!MM~~~~~
MMM~MMMM~~~~~~
MMM~~~M~~~~~~~
M~~~~~~~~~~~~~
MM~~~~~~~~~~~~
